


              NO    ./textures/test.png                        
        EA    ./textures/wallcub.png                                     
SO ./textures/wallcub.png
   WE            ./textures/wallcub.png

                 NO    ./textures/green_tx10x10px.png                        
        EA    ./textures/wallcub.png                                     
SO ./textures/blue_tx10x10px.png
   WE            ./textures/wallcub2.png



C 20,10,200
F 20,100,000000000020
22222222222222222222222222222222
20101010101010101010101010101012
20S00000000000000000000000000002
21010101010101010101010101010102
20000000000000000000000000000002
20101010101010101010101010101012
20000000000000000000000000000002
21010101010101010101010101010102
20000000000000000000000000000002
20101010101010101010101010101012
20000000000000000000000000000002
21010101010101010101010101010102
20000000000000000000000000000002
20101010101010101010101010101012
20000000000000000000000000000002
21010101010101010101010101010102
20000000000000000000000000000002
20101010101010101010101010101012
20000000000000000000000000000002
21010101010101010101010101010102
20000000000000000000000000000002
22222222222222222222222222222222