


              NO    ./textures/test.png                        
        EA    ./textures/wallcub.png                                     
SO ./textures/wallcub.png
   WE            ./textures/wallcub.png

                 NO    ./textures/green_tx10x10px.png                        
        EA    ./textures/wallcub.png                                     
SO ./textures/blue_tx10x10px.png
   WE            ./texture/wallcub2.png



C 20,10,200
F 20,100,000000000020
11111111111111111111111111111111
10101010101010101010101010101011
10W0000000000000000000000000001
110101010101010101010D0101010101
10000000000000000000000000000001
10101010101010101010101010101011
10000000000000000000000000000001
11010101010101010101010101010101
10000000000000000000000000000001
10101010101010101010101010101011
10000000000000000000000000000001
11010101010101010101010101010101
10000000000000000000000000000001
10101010101010101010101010101011
10000000000000000000000000000001
11010101010101010101010101010101
10000000000000000000000000000001
10101010101010101010101010101011
10000000000000000000000000000001
11010101010101010101010101010101
10000000000000000000000000000001
11111111111111111111111111111111