11111111
10000001
10E00001
10000001
22222222