1111111111111111
1000000000000001
1001110000000001
1000000001110001
1111111111000001
1000000111000001
1001110001000001
1000000001000011
1111111111111111