2222222222222222222222
2101010100000000000001
2000000000000011110001
200000000000001  10001
2000000E1001111  10001
200000000000001  10001
220202200000000  10001
111111100000001  10001
      100000001  10001
      1000200011110001
      1000000000000001
      2222222222222221