NO ./textures/bush1.png             
SO ./textures/bush2.png
WE ./textures/bush3.png
EA ./textures/bush4.png
WC ./textures/wtf.png
C 60, 189, 169
F 117, 89, 13

        1111111
        1000001
        1000001
11111111100000011111111
10000000000000000000001
10000000000000000000001
10000001000000000000001
10000100010000000011111
100000010000000000000011111111
1000W0000000000000000010000001
100000010000000000000000000001
100000101000000000000000000001
100000010000000001111111111111
11111111100000111111111
        1000001
        1000001
        1000001
        1000001
        1000001
        1000001
        1000001
        1000001
        1000001
        1000001
        1000001
        1000001
        1000001
        1000001
        1000001
        1000001
        1000001
        1000001
        1000001
        1000001
        1000001
        1000001
        1000001
        1000001
        1000001
        1000001
        1000001
        1000001
        1000001
        1000001
        1000001
        1000001
        1000001
        1000001
        1000001
        1000001
        1000001
        1000001
        1000001
        1000001
        1000001
        1000001
        1000001
        1000001
        1000001
        1000001
        1000001
        1000001
        1000001
        1000001
        1000001
        1000001
        1000001
        1000001
        1000001
        1000001
        1000001
        1000001
        1000001
        1000001
        1000001
        1000001
        1000001
        1000001
        1000001
        1111111