NO ./textures/test.png             
SO ./textures/wallcub.png
WE ./textures/wallcub2.png
EA ./textures/wtf.png

F 220,100,0
C 200,80,100

        1111111
        1000001
        1000001
11111111100000011111111
10000000000000000000001
10000000000000000000001
10000001000000000000001
10000100010000000011111
100000010000000000000011111111
1000W00000000D0000000010000001
100000010000000000000000000001
100000101000000000000000000001
100000010000000001111111111111
11111111100000111111111
        1000001
        1000001
        1000001
        1000001
        1000001
        1000001
        1000001
        1000001
        1000001
        1000001
        1000001
        1000001
        1000001
        1000001
        1000001
        1000001
        1000001
        1000001
        1000001
        1000001
        1000001
        1000001
        1000001
        1000001
        1000001
        1000001
        1000001
        1000001
        1000001
        1000001
        1000001
        1000001
        1000001
        1000001
        1000001
        1000001
        1000001
        1000001
        1000001
        1000001
        1000001
        1000001
        1000001
        1000001
        1000001
        1000001
        1000001
        1000001
        1000001
        1000001
        1000001
        1000001
        1000001
        1000001
        1000001
        1000001
        1000001
        1000001
        1000001
        1000001
        1000001
        1000001
        1000001
        1000001
        1000001
        1111111