LLLLLLLL222222268468468LLLLLLL
LLLLLLLL200000268468468LLLLLLL
LLLLLLLL200000268468468LLLLLLL
12121212100000021212121LLLLLLL
1S000000000000000000002LLLLLLL
10000000000000000000002LLLLLLL
10000001000000000000002LLLLLLL
10000100010000000011112LLLLLLL
100000010000000000000011111111
100000000000000000000020000001
100000020000000000000000000001
100000202000000000000000000001
100000020000000002222221111111
10000000000000000000002LLLLLLL
10000000000000000000002LLLLLLL
10000000000000000000002LLLLLLL
12222222200000222222222LLLLLLL
LLLLLLLL2000001LLLLLLLLLLLLLLL
LLLLLLLL2000002LLLLLLLLLLLLLLL
LLLLLLLL2000001LLLLLLLLLLLLLLL
LLLLLLLL2000002LLLLLLLLLLLLLLL
LLLLLLLL2000001LLLLLLLLLLLLLLL
LLLLLLLL2000002LLLLLLLLLLLLLLL
LLLLLLLL2000001LLLLLLLLLLLLLLL
LLLLLLLL2000002LLLLLLLLLLLLLLL
LLLLLLLL2000001LLLLLLLLLLLLLLL
LLLLLLLL2000002LLLLLLLLLLLLLLL
LLLLLLLL2000001LLLLLLLLLLLLLLL
LLLLLLLL2000002LLLLLLLLLLLLLLL
LLLLLLLL2000001LLLLLLLLLLLLLLL
LLLLLLLL2000002LLLLLLLLLLLLLLL
LLLLLLLL2000001LLLLLLLLLLLLLLL
LLLLLLLL2000002LLLLLLLLLLLLLLL
LLLLLLLL2000001LLLLLLLLLLLLLLL
LLLLLLLL2000002LLLLLLLLLLLLLLL
LLLLLLLL2000001LLLLLLLLLLLLLLL
LLLLLLLL2000002LLLLLLLLLLLLLLL
LLLLLLLL2000001LLLLLLLLLLLLLLL
LLLLLLLL2000002LLLLLLLLLLLLLLL
LLLLLLLL2000001LLLLLLLLLLLLLLL
LLLLLLLL2000002LLLLLLLLLLLLLLL
LLLLLLLL2000001LLLLLLLLLLLLLLL
LLLLLLLL2000002LLLLLLLLLLLLLLL
LLLLLLLL2000001LLLLLLLLLLLLLLL
LLLLLLLL2000002LLLLLLLLLLLLLLL
LLLLLLLL2000001LLLLLLLLLLLLLLL
LLLLLLLL2000002LLLLLLLLLLLLLLL
LLLLLLLL2000001LLLLLLLLLLLLLLL
LLLLLLLL2000002LLLLLLLLLLLLLLL
LLLLLLLL2000001LLLLLLLLLLLLLLL
LLLLLLLL2000002LLLLLLLLLLLLLLL
LLLLLLLL2000001LLLLLLLLLLLLLLL
LLLLLLLL2000002LLLLLLLLLLLLLLL
LLLLLLLL2000001LLLLLLLLLLLLLLL
LLLLLLLL2000002LLLLLLLLLLLLLLL
LLLLLLLL2000001LLLLLLLLLLLLLLL
LLLLLLLL2000002LLLLLLLLLLLLLLL
LLLLLLLL2000001LLLLLLLLLLLLLLL
LLLLLLLL2000002LLLLLLLLLLLLLLL
LLLLLLLL2000001LLLLLLLLLLLLLLL
LLLLLLLL2000002LLLLLLLLLLLLLLL
LLLLLLLL2000001LLLLLLLLLLLLLLL
LLLLLLLL2000002LLLLLLLLLLLLLLL
LLLLLLLL2000001LLLLLLLLLLLLLLL
LLLLLLLL2000002LLLLLLLLLLLLLLL
LLLLLLLL2000001LLLLLLLLLLLLLLL
LLLLLLLL2000002LLLLLLLLLLLLLLL
LLLLLLLL2000001LLLLLLLLLLLLLLL
LLLLLLLL2000002LLLLLLLLLLLLLLL
LLLLLLLL2000001LLLLLLLLLLLLLLL
LLLLLLLL2000002LLLLLLLLLLLLLLL
LLLLLLLL2000001LLLLLLLLLLLLLLL
LLLLLLLL2000002LLLLLLLLLLLLLLL
LLLLLLLL2000001LLLLLLLLLLLLLLL
LLLLLLLL2000002LLLLLLLLLLLLLLL
LLLLLLLL2000001LLLLLLLLLLLLLLL
LLLLLLLL2000002LLLLLLLLLLLLLLL
LLLLLLLL2000001LLLLLLLLLLLLLLL
LLLLLLLL2000002LLLLLLLLLLLLLLL
LLLLLLLL2000001LLLLLLLLLLLLLLL
LLLLLLLL2000002LLLLLLLLLLLLLLL
LLLLLLLL2000002LLLLLLLLLLLLLLL
LLLLLLLL2222222LLLLLLLLLLLLLLL