1111111111111
1000000000001
1000000000001
100000S000001
1000000000001
1000000000001
1112121212111