LLLLLLLL2222222
LLLLLLLL2000002
LLLLLLLL2000002
12121212100000021212121
10000000000000000000002
10000000000000000000002
10000001000000000000002
10000100010000000011112
100000010000000000000011111111
1000E0000000000000000020000001
100000020000000000000000000001
100000202000000000000000000001
100000020000000002222221111111




10000000000000000000002
10000000000000000000002
10000000000000000000002
12222222200000222222222
LLLLLLLL2000001
LLLLLLLL2000002
LLLLLLLL2000001
LLLLLLLL2000002
LLLLLLLL2000001
LLLLLLLL2000002
LLLLLLLL2000001
LLLLLLLL2000002
LLLLLLLL2000001
LLLLLLLL2000002
LLLLLLLL2000001
LLLLLLLL2000002
LLLLLLLL2000001
LLLLLLLL2000002
LLLLLLLL2000001
LLLLLLLL2000002
LLLLLLLL2000001
LLLLLLLL2000002
LLLLLLLL2000001
LLLLLLLL2000002
LLLLLLLL2000001
LLLLLLLL2000002
LLLLLLLL2000001
LLLLLLLL2000002
LLLLLLLL2000001
LLLLLLLL2000002
LLLLLLLL2000001
LLLLLLLL2000002
LLLLLLLL2000001
LLLLLLLL2000002
LLLLLLLL2000001
LLLLLLLL2000002
LLLLLLLL2000001
LLLLLLLL2000002
LLLLLLLL2000001
LLLLLLLL2000002
LLLLLLLL2000001
LLLLLLLL2000002
LLLLLLLL2000001
LLLLLLLL2000002
LLLLLLLL2000001
LLLLLLLL2000002
LLLLLLLL2000001
LLLLLLLL2000002
LLLLLLLL2000001
LLLLLLLL2000002
LLLLLLLL2000001
LLLLLLLL2000002
LLLLLLLL2000001
LLLLLLLL2000002
LLLLLLLL2000001
LLLLLLLL2000002
LLLLLLLL2000001
LLLLLLLL2000002
LLLLLLLL2000001
LLLLLLLL2000002
LLLLLLLL2000001
LLLLLLLL2000002
LLLLLLLL2000001
LLLLLLLL2000002
LLLLLLLL2000001
LLLLLLLL2000002
LLLLLLLL2000001
LLLLLLLL2000002
LLLLLLLL2000002
LLLLLLLL2222222